can't hold us - macklemore
as long as you love me - bustin jieber
human - christina perri
love you still (sappy love song) - tyler shaw
that's hilarious - charlie puth
929 - halsey
i will survive - gloria gaynor
numb - linkin park
i hope - gabby barrett
so good - halsey
the funeral - yungblud
11 minutes - halsey & yungblud
polygraph eyes - yungblud
sorry - halsey
heather - conan gray
jealous - labrinth
graveyard - halsey
memories - yungblud & willow
little me - little mix
love me more - sam smith
hold my hand - lady gaga
no time to die - billie eilish
fingers crossed - lauren spencer-smith
lie to me - 5 seconds of summer
i don't wanna live forever - zayn & taylor swift
me myself & i - 5 seconds of summer
minefields - faouzia & john legend
flowers need rain - preston pablo
mars - yungblud
you don't go to parties - 5 seconds of summer